R 1000 700
NO ./textures/bukJJOCK.xpm
SO ./textures/newdoggo.xpm
WE ./textures/jindo.xpm
EA ./textures/gyeonbin.xpm
S ./textures/sprite.xpm
FT ./textures/ground.xpm
CT ./textures/sky1.xpm
F 167,167,167
C 54,54,54

1 1 1 1 1 1 1 1 1 1 1 1 1 1 1 1 1
1 2 0 2 2 0 0 2 1 2 0 2 1 2 0 2 1
1 0 0 0 2 0 0 0 1 0 0 0 1 0 0 0 1
1 2 0 0 0 0 0 1 1 0 0 0 0 0 0 0 1
1 0 0 0 0 0 0 0 1 0 0 0 0 0 0 0 1
1 1 1 1 1 0 0 0 0 0 0 0 0 0 0 0 1
1 0 N 0 0 0 0 0 1 0 0 0 0 0 0 0 1
1 0 2 0 1 0 0 0 1 0 0 0 0 0 0 0 1
1 1 1 1 1 1 1 1 1 1 1 1 1 1 1 1 1